25 25
iccccccc ccccccc ccccccck
aP·····················Pb
a·jdddddddl·H·jdddddddl·b
a·gccccccce·H·gccccccce·b
a···········H···········b
a·fcccch·fHHHHHh·fcccch·b
a·H    H·HH···HH·H    H·b
a·kddddi····o····kddddi·b
a········HH···HH········b
a·HHHHHH·kHHHHHi·HHHHHH·b
 ······················· 
aofc-ch-HHHH·HHHH-fc-chob
a-HGGGH·····o·····HGGGH-b
a·Hd-dH·jddd-dddl·Hd-dH·b
a·······b·······a·······b
a·fHHHHHi·fHHHh·kHHHHHh·b
a·H···················H·b
a·H·jdddddddddddddddl·H·b
a·H·ba······o······ba·H·b
a·H·ba·fHHHH-HHHHh·ba·H·b
a·H·ge·H·········H·ge·H·b
a·H····H·fcc-cch·H····H·b
a·k·HHHi·HGGGGGH·kHHH·i·b
aP·······HGGGGGH·······Pb
hddddddd HdddddH dddddddf